11111111111111111111
10000000000000000001
10111101111101111101
101000010E0001000101
10101111011111011101
10100000010000000001
10101111111111111001
10100000000000000001
10101111111111111101
10000000000000000001
11111111111111111111