11111111111111111111
10000000000000000001
10111101111101111101
10100001000001000101
10101111011111011101
10100000010000000001
10100000000000000001
10100000001111000001
1010000000000N100001
10000000000000000001
11111111111111111111