11111111
10001001
10000101
100W0001
11000101
10100001
11111111