NO Textures/wall.xpm
SO Textures/wall.xpm
WE Textures/wall.xpm
EA Textures/wall.xpm

F 164,169,20
C 153,204,255

111111111111111111111
11111111111111111111111111111
101010101011111110001
100010100010000010001
111110101111101011101
100000101000101000001
101101011101111100001111111111111
101000001010110000011
101011111010111110101
101010001010100010101
101110101010101010101
100000101010001010001
111111101011111011101
100000111111111111111
101110101110101110111
101000100000100010101
101011111111111010101
100010000000000010001
10010111011111111101
1N0000000000000000101
111111111111111111111
