F 76,76,76
C 99,99,99

NO Textures/wall.xpm
SO Textures/wood.xpm
WE Textures/west.xpm
EA Textures/wall.xpm

1111111111111111111
1111111111111111111
1011001001001000001
1011000111111111111
1000S00111111111111
1001111111111111111
1000000000000001001
1001111111111001001
1111000000000001011
1000000001000000001
1111111111111111111

