
NO                              ./textures/north.xpm
                  SO                      ./textures/south.xpm
WE                ./textures/west.xpm
EA ./textures/east.xpm

F 220,100,0
C 0,255,255

111111
100001
10N001
111111
